XXXXXXXXXXXXXXXXXXXXXXXXXXXXXXXXXXXXXXXXXXXXXXXXXXXXXXXXXXXXXXXXXXXXXXXXXX
Xa1047123651023956123051923756103812031X1X2935721X3123725X71X65173138X151X
X1263891038919123912902148561b10230170127301340605613701X125X75XX16XX1284X
X5761X274X17X5X165X16X23X165X26X461X23X164X612X6X461X65X1264X65X61X56X165X
X6501260731X275X62X137927X76X172X7X1273X175X1273X17X571X274X17523X7X751X2X
X652163Xc25X273X12X1752X6X46X12X526X165X1624X6X624X16X561X256X1624X1642X6X
X6521603601640216501627X1723X12X57X27X15616237X1X3X823X18X2381X283X183X81X
X45654567654567876543456789890X098765012630X606056012X3X123X71X37X17d2X71X
XXXXXXXXXXXXXXXXXXXXXXXXXXXXXXXXXXXXXXXXXXXXXXXXXXXXXXXXXXXXXXXXXXXXXXXXXX

